Name	Hindi_lang
Arapesh	अल्पेश
Aari	ऐरी
Abau	अबाउ
Arabic	अरबी
Abidji	आबिदजी
Arabic	अरबी
Arabic	अरबी
Abkhaz	अबखज़
Alabama	अलबामा
Arabana	अरबन
Arbore	अरबोर
Abun	पाव रोटी # मीठी रोटी
Abui	अबुई
Abenaki	आबनाकी
Abaza	अबजा
Acehnese	ऐशेंसी
Achagua	अचगुआ
Acholi	अचोली
Achumawi	अचुमावी
Achang	अचंग
Acoma	ए कोमा
Achuar	अचौर
Adamorobe Sign Language	Adamorobe सांकेतिक भाषा
Adang	अदंग
Adioukrou	आदिकौक्र
Andoke	एंडोक
Adynyamathanha	आदिमनाथन
Adyghe	अदिघे
Adyghe	अदिघे
Adzera	एडज़ेरा
Aleut	अलेउत
Arabic	अरबी
Arabic	अरबी
Afrikaans	अफ्रीकी
Agarabi	अगरबती
Agta	अगता
Agta	अगता
Aghem	अगम
Aghul	अघुल
Angami	अंगामी
Angolar	अंगदान करनेवाला
Aguaruna	अगुरूना
Anguthimri	अंगुठीमरी
Aguacatec	अगुआटेक
Alagwa	अलागवा
Arapaho	अराफाओ
Arabic	अरबी
Ahtna	आहट
Aghu	अघू
Ainu	आइनु
Aizi	आइज़ि
Aja	आजा
Ajagbe	अजगबे
Aka	आका
Aka-Biada	आका-बियाडा
Aka-Cari	आका-कैरी
Akha	अखा
Aka-Kede	आका-केडे
Aklanon	अकलानन
Arakanese	अरकानी
Akan	अकान
Arabic	अरबी
Arikara	अरिकारा
Akawaio	अकावायो
Alamblak	आलमबलाक
Albanian	अल्बानियाई
Allentiac	एलेंटिक
Alladian	अल्लडियन
Aleut	अलेउत
Algonquin	अल्गुनकिन
Arop-Lokep	अरोप-लोकप
Ala'ala	अलाअला
Alune	Alune
Alsea	Alsea
Alsatian	Alsatian
Alutor	अलटर
Alawa	अलवा
Alas	काश
Alyawarra	एल्यवरा
Amara	अमारा
Ambulas	एंबुलेस
Amahuaca	अमहुआका
Amdo	आमदो
Amele	अमेल
Amharic	अम्हारिक्
Amis	एमिस
Amarakaeri	अमराकरी
Ambae	अंबे
Ama	अमा
Amanab	अमानब
Amo	आमो
Arrernte	एरेर्नेट
Ambai	अंबाई
Arabic	अरबी
Arabic	अरबी
Amdo	Amdo
Amuesha	अमीषा
Anamuxra	अनामुक्ष
Amuzgo	अमुजो
Araona	अरोना
Angas	अंगस
Anggor	अंगरेज
//Ani	// एनी
Anejom	Anejom
Arabic	अरबी
Anindilyakwa	अनिंदिलकवा
Anong	अनंग
Angaataha	अंगदाहा
Anufo	Anufo
Andi	और मैं
Anywa	एनीवा
Ao	ए ओ
Mufian	मुफ़ियान
Arabic	अरबी
Apache	अपाचे
Ampeeli	अमपेली
Apache	अपाचे
A-Pucikwar	उ० — पुसिकवार
Apatani	अपातानी
Apache	अपाचे
Arawak	अरावक
Arabela	अरेबला
Archi	अर्ची
Arandai	अरंडई
Arabic	अरबी
Arabic	अरबी
Aribwatsa	अरीबवत्स
Arabic	अरबी
Araki	अर्की
Arabic	अरबी
Armenian	अर्मेनियाई
Arabic	अरबी
Arosi	अरसी
Arapesh	अर्पेश
Arabic	अरबी
Arrernte	गिराने की क्रिया या भाव
Arabic	अरबी
Arabic	अरबी
Armenian	अर्मेनियाई
'Are'are	'कर रहे हैं
Armenian	अर्मेनियाई
Adyghe	अदिघे
American Sign Language	अमेरिकी सांकेतिक भाषा
Asmat	अस्मत
Altai	अल्ताई
Assamese	असमिया
Asturian	स्वर्ग
Arabic	अरबी
Atayal	आत्याल
Aralle-Tabulahan	अर्ले-तबलुहन
Atchin	अचिन
Athpare	अथापर
Atikamekw	अतीकेमकेव
Atakapa	अताकापा
Alutiiq	अलुतिक़
Atsugewi	अत्सुगुवाई
Arabic	अरबी
Au	औ
Aulua	औलुआ
Auslan	औसलन
Auyana	औयाना
Avar	अवार
Avikam	अविकम
Avokaya	अवोकेया
Avatime	अवतरण
Awa	आवा
Awadhi	अवधी
Arrernte	एरेर्नेट
Aekyom	आक्योम
Akwa	अकवा
Awngi	अवंगी
Awa Pit	आवा पिट
Awtuw	अस्तु
Awyi	अवी
Akhvakh	अखवाख
Anyi	एनी
Aymara	आयमारा
Aynu	अयनू
Ayoreo	अयोरे
Ayiwo	अइवो
Azerbaijani	अज़रबैजानी
Azari	अज़ारी
Barai	बरई
Babungo	बबुंगो
Bachamal	बचमाल
Bade	बाडे
Bafut	बाफुत
Bagirmi	बगमीरी
Xiriana	ज़िरियाना
Bai	बाई
Bajau	बजाऊ
Baka	बाका
Balinese	बालिनी
Bambara	बम्बारा
Bana	बाना
Bao'an	बावन
Baure	चारा
Bari	बारी
Batak	बटुक
Bau	बाऊ
Bawm	बावम
Babole	बाबोल
Bambam	मस्त है
Barambu	बारम्बु
Bininj Gun-Wok	बिनिनज गुन-वोक
Bandjalang	बैंडजालंग
Berber	बर्बर
Bella Coola	बेला कुला
Berbice Dutch Creole	बर्बिस डच क्रेओल
Badaga	बडगा
Budukh	बुधु
Badimaya	बदिमाया
Budu	बुडू
Baham	बहम
Benabena	बेनाबेना
Bengali	बंगाली
Beembe	बेम्बे
Begak-Ida'an	बेगक-इदैन
Beja	बेजा
Belhare	बेलहारे
Bemba	बेम्बा
Bengali	बंगाली
Beothuk	बेतुक
Berta	बर्टा
Bezhta	बेजता
Biafada	बियाफ़डा
Berber	बर्बर
Bafia	बाफिया
Benga	बेंगा
Banggai	बँगाई
Bagri	बागड़ी
Buglere	बगलेरे
Bangime	बैंगाइम
Bugun	बुगुन
Bongo	बोंगो
Bagiro	बगरियो
Baga Sitemu	बैगा सीतामऊ
Bagvalal	बगवाल
Banggi	बंगी
Bhili	भीली
Bahinemo	बहिनमो
Bhojpuri	भोजपुरी
Bhumij	भौमिज
Bila	बिला
Bidiya	बिदिया
Binga	बिंगा
Biri	बीरी
Biak	बायक
Bilua	बिलुआ
Bima	बिमा
Binandere	बिनांडरे
Nai	नाइ
Bilaan	बिलन
Birom	बायोम
Bisa	बीसा
Biatah	बिताह
Bisu	बिसु
Sama	समा
Baka	बका
Betta Kurumba	बेट्टा कुरुम्बा
Binukid	बिनुकिद
Bikol	बिकोल
Bakundu	बैकुंठ
Batak	बटक
Brokskat	ब्रक्सकट
Bakueri	बकुरी
Blackfoot	ब्लैकफुट
Baluchi	बलूची
Baule	बाउल
Balangao	बलांगो
Baale	बाले
Balantak	बालंतक
Bilin	बिलिन
Bole	बोले
Belorussian	बेलोरूसियन
Balti	बलती
Bena-Lulua	बेना-लुलुआ
Biloxi	बिलोक्सी
Balyku	बाल्यकु
Balanta	बलंता
Berber	बर्बर
Bimoba	बिंबा
Bamun	बामुन
Burum	बरुम
Berber	बर्बर
Bunuba	बनुबा
Bandi	बांदी
Qaget	क़गेट
Bini	बिनी
Bandjalang	बंजलंग
Bankon	विश्वास करना
Banggarla	बंगरगला
Binumarien	बिनुमारिन
Banoni	बनौनी
Waimaha	वइमहा
Beng	बेंग
Bilinarra	बिलिनिर्रा
Bantik	बैंटिक
Bularnu	बुलारनु
Baniva	बनिवा
Baniwa	बनियावा
Boazi	बोआजी
Bobangi	बोबांगी
Bodo	बोडो
Boiken	बोइकेन
Bori	बोरी
Boko	बोको
Bolia	बोलिया
Bongu	बोंगू
Bokar	बोकर
Bora	बोरा
Bosnian	बोस्नियाई
Berber	बर्बर
Bozo	बोजो
Bura-Pabir	बूरा-पाबीर
Bahnar	बहन्नर
Basque	बास्क
Basque	बास्क
Basque	बास्क
Basque	बास्क
Basque	बास्क
Basque	बास्क
Basque	बास्क
Basque	बास्क
Basque	बास्क
Basque	बास्क
Brao	ब्रो
Bariba	बारिबा
Boruca	बोरूका
Bardi	बाड़ी
Breton	ब्रेटन
Berber	बर्बर
Brahui	ब्राहुई
Bribri	रिश्वत
Burji	बुर्जी
Berik	बेरीक
Baragaunle	बैरागनल
Burmese	बर्मी
Burunge	बरगद
Broken	टूटा हुआ
Barupu	बारुपु
Bera	बेरा
Bororo	बोरो
Barasano	बरसाना
Bru	ब्रू
Bru	ब्रू
Baruya	बरुआ
Birri	बिर्री
Berber	बर्बर
Bushoong	बुशॉन्ग
Berber	बर्बर
Bashkir	बशकिर
British Sign Language	ब्रिटिश सांकेतिक भाषा
Bislama	बिस्लामा
Basque	बास्क
Basque	बास्क
Basari	बसारी
Bathari	बथारी
Betoi	बेटोई
Bontok	बंटोक
Batak	बटक
Burarra	बुरारा
Bubi	बुबी
Buduma	बुडुमा
Bugis	बुगिस
Buli	Buli
Bujeba	बुजेबा
Bukusu	बकुसु
Bulgarian	बल्गेरियाई
Buma	बुमा
Buin	Buin
Burushaski	बुरुशकी
Busa	बुसा
Buriat	बरियात
Buru	बुरु
Bulu	बुलु
Buli	Buli
Bali-Vitu	बाली-विटु
Bandjalang	बंदजालंग
Bajau	बजाऊ
Bayungu	बायंगु
Byansi	बायसी
Bayso	बायसो
Bandjalang	बंदजालंग
Bauzi	बाजी
Cacua	कछुआ
Caddo	कड्डो
Cahuilla	काहिला
Chai	चाई
Cakchiquel	Cakchiquel
Candoshi	कैंडोशी
Capanahua	कपानहुआ
Carib	कैरिब
Cashibo	कैशिबो
Catio	अनुपात
Campa	कैम्पा
Cayapa	केयापा
Chumash	चुमाश ओ)
Chocho	चोचो
Chickasaw	चिकसाव
Chinantec	चिनेंटेक
Chasta Costa	चस्टा कोस्टा
Cocopa	कोकपा
Choctaw	चोक्टाव
Carib	कैरिब
Cree	क्री
Cebuano	सिबुआनो
Chicomuceltec	चिकोमुकेल्टेक
Chaga	चागा
Chamorro	चमोरो
Chambri	चम्बरी
Chechen	चेचन
Chaudangsi	चौडांगी
Cherokee	चेरोकी
Chang	चांग
Chaha	चहा
Chimariko	चिमारिको
Chuj	चुज
Chukchi	चुच्ची
Chehalis	चेहलिस
Chamalal	चमलाल
Chantyal	चन्याल
Chontal	चोंटल
Chipewyan	चिपवयन
Chinantec	चिनेंटेक
Chrau	चरु
Chin	चिन
Chatino	चैटिनो
Nivacle	Nivacle
Chuvash	चुवाश
Cham	चम
Chontal	चोंटल
Chayahuita	च्यहुइता
Chichewa	चिचेवा
CiLuba	सिउलबा
Chumash	चुमाश ओ)
Chichimeca-Jonaz	चिचिम्का-जोनाज़
Cheke Holo	चोको होलो
Chinook	चिनूक
Chinook	चिनूक
Clallam	क्ललम
Colac	कोलाक
Chaldean	चेल्डेन
Chinantec	चिनेंटेक
Chulym	चुलिम
Chimila	चीमिला
Comecrudo	Comecrudo
Cham	चम
Chemehuevi	चेमेहुवी
Chemakum	चेमाकुम
Camling	चुगली करना
Comanche	कॉमंच
Chin	चिन
Comox	Comox
Chontal Maya	चोंटल माया
Canela	कैनेला
Cantonese	कैंटोनीज़
Coahuilteco	कोआहिल्लितेको
Cocama	कोकामा
Coeur d'Alene	Coeur d'Alene
Cogui	कोगुई
Chol	चोल
Comorian	कोमोरियन
Coos	कूस
Coptic	कॉप्टिक
Cora	कोरा
Rumsien	रम्सियन
Campa Pajonal Asheninca	कैम्पा पाजोनल अशीनिंका
Chinantec	चिनेंटेक
Chepang	चेपांग
Chippewa	चिप्पेवा
Chipaya	चिपया
Chiquitano	
Cree	
Chiriguano	चिरिगुआनओ
Chru	चुरू
Crimean Tatar	क्रीमियन तातार
Carijona	कैरिजोना
Creek	क्रीक
Carolinian	कैरोलिनियन
Cornish	कोर्निश
Crow	कौआ
Carapana	कारापाना
Carrier	वाहक
Chorote	कोरोटे
Chinantec	चिनेंटेक
Chinantec	चिनेंटेक
Cashinahua	कैशिनहुआ
Diola-Kasa	डायला-कासा
Chinese Sign Language	चीनी सांकेतिक भाषा
Chatino	चैटिनो
Cuicatec	Cuicatec
Chinantec	चिनेंटेक
Chin	चिन
Catalan	कैटलन
Chitimacha	चिटिमचा
Chatino	चैटिनो
Catawba	कैटावबा
Cua	कुआ
Cubeo	घन
Cuica	Cuica
Cuiba	क्यूइबा
Culina	कुलिना
Chumburung	चुम्बुरंग
Curripaco	कर्पूरको
Cuitlatec	Cuitlatec
Chuukese	चौकीज
Chavacano	चवाकोनो
Chuave	चुवे
Columbia-Wenatchi	कोलंबिया-वेनेची
Chatino	चैटिनो
Cayuga	केयुगा
Cheyenne	चेयेने
Cayuvava	केवुवा
Czech	चेक
Da'a	Da'a
Daba	डाबा
Dadibi	दादिब
Daga	डागा
Dahalo	दहलो
Dakota	डकोटा
Damana	दमना
Dan	दान
Darai	दराई
Datooga	दत्तयोग
Day	दिन
Dabida	दबिदा
Dutch	डच
Dumagat	डुमगाट
Dhuwal	धुवाल
Daju	दाजु
Donno So	डोनो सो
Defaka	डेकाका
Degema	डीगमा
Dla	डाला
Desano	डेसानो
Deti	Deti
Deuri	देउरी
Dagaare	दागारे
Dagbani	दागबनी
Dogri	डोगरी
Dongo	डोंगो
Dagur	दागुर
Degexit'an	डेगेक्सिटैन
Dhaasanac	धसानक
Dharumbal	धरमबल
Dhivehi	धिवेही
Dhalandji	धनलैंडजी
Dhimal	ढिमल
Dhargari	धारगारी
Dhurga	दुर्गा
Dharawal	धरावल
Didinga	डिडिंगा
Digaro	डिगरो
Dime	डाइम
Dinka	दिनका
Diola-Fogny	डायला-फोगनी
Diyari	दियारी
Dizi	डिजी
Djabugay	दूबगाय
Djingili	जिंगिली
Djambarrpuyngu	Djambarrpuyngu
Djinang	जिनांग
Djapu	Djapu
Djaru	Djaru
Dutch	डच
Dla	डाला
Duma	डूमा
Dumi	दूमी
Domaaki	दोमाकी
Dimasa	दिमसा
Ding	डिंग
Dani	दानी
Dobel	डोबेल
Doko	डोको
Dolgan	डोलगन
Domari	डोमरी
Dong	डोंग
Doutai	दोताई
Doyayo	दोययो
Drehu	द्रुह
Dargwa	दरगवा
Dari	दारी
Darma	कर्म
Danish	दानिश
Toro So	तोरो तो
Duala	द्वैत
Dullay	दुल्ले
Duka	डोका
Dulong	दुलंग
Dumo	डुमो
Duna	दूना
Dutch	डच
Dutch	डच
Dyirbal	दिरबल
Dyimini	डायमिनी
Dyula	दयौला
Ebira	एबिरा
Edolo	एडोलो
Efik	इफिक
Ega	ईगा
Engenni	इंगेंनी
Eipo	ईपो
Ejagham	ईजगम
Ekari	एकरी
Ekoti	एकोती
Elseng	एल्सेंग
Embera Chami	एम्बर चामी
Embaloh	अम्बालोह
Emmi	अम्मी
Enga	इंजी
Enets	एनसेट करता है
English	अंग्रेज़ी
Enggano	एंगगनो
Enya	एन्या
Epena Pedee	एपिना पेडी
Efate	Efate
Erromangan	एरोमंगन
Ese Ejja	एसे ईजा
Esselen	एस्सेलेन
Estonian	एस्टोनियाई
Etsako	इत्सको
Eudeve	एदेवे
Evenki	इवनकी
Even	यहाँ तक की
Ewe	ईवे
Ewe	ईवे
Ewondo	इवांडो
Eyak	आईक
Faroese	प्रेमी
Fasu	फासु
Fula	फूला
Frisian	पश्चिमी
Fe'fe'	फे'फ '
Fula	फूला
Fijian	फिजियन
Finnish	फिनिश
Fiote	को बढ़ावा देना
Fijian	फिजियन
Ful	फुल
Fula	फूला
Fulfulde	फुलफुड
Frisian	पश्चिमी
Foe	धिक्कार है
Fongbe	फोंगबे
Fore	हमेशा के लिए
Fox	लोमड़ी
Momu	मोमु
Fordata	फोर्डटा
French	फ्रेंच
Frisian	पश्चिमी क्षेत्र
Frisian	पश्चिमी
Finnish Sign Language	फिनिश सांकेतिक भाषा
Fulfulde	फुलफूड
Futuna	फ़्यूचूना
Fulfulde	फुलफूड
Fur	फर
Fula	फूला
Futuna-Aniwa	फुटुना-अनीवा
Fuzhou	फूजो
Fyem	फईम
Gaagudju	गागुडजू
Gade	गाडे
Gaelic	गेलिक
Gagauz	गागुज
Gahuku	गहुकु
Galo	गैलो
Gamo	गामो
Great Andamanese	महान अंडमानी
Gapapaiwa	गपपइवा
Garo	गारो
German	जर्मन
Gayo	गायो
German	जर्मन
Gbeya Bossangoa	गबेया बोसांगोआ
Guinea Bissau Crioulo	गिन्नी बिसाउ क्रायलो
German	जर्मन
Gbaya	Gbaya
German	जर्मन
Gbaya	Gbaya
Greek	ग्रीक
Gutob	गुटोब
Guduf	गुदुफ
Gadaba	गडाबा
Guadeloupe Creole	गुआदेलूप क्रेओल
Gidar	गिडार
Gadsup	गदसप
Gela	गेला
Georgian	जॉर्जियाई
German	जर्मन
Guianese French Creole	गुआनीज़ फ्रेंच क्रियोल
Gugadj	गुगदज
Gureng Gureng	गुरेंग गुरेंग
German	जर्मन
Guahibo	गुहिबो
Ghotuo	घोटुओ
Bunan	बान
Gidabal	गीदबल
Gilaki	गिलकी
Gimira	गिमिरा
Gula Iro	गुला इरो
Gitksan	गीताक्षन
Giziga	Giziga
Gurindji	गुरिन्दजी
Guajajara	गुज्जारा
Gelao	गेलो
Galician	गैलिशियन
Galela	गैला
Golin	गोलिन
Gaalpu	गालपु
German	जर्मन
Guambiano	ग्वाम्बियानो
Gamilaraay	गामिलराय
Gumatj	गुमतज
Gumawana	गुमवाना
Gumuz	गुमुज
Guana	गुनाह
Gunbalang	गुनबलंग
Ga'anda	Ga'anda
Gunin	गुनिन
Guanano	गुआनानो
Gunya	गुनिया
Goajiro	गूजीरो
Godoberi	देवबंदी
Goemai	गोइमाई
Gogodala	गोगोडाला
Gojri	गोजरी
Gokana	गोकरण
Gola	गोला
Gondi	गोंडी
Gooniyandi	गोयनंदी
Gorowa	गोरोवा
German	जर्मन
German	जर्मन
Grebo	ग्रीबो
Greenlandic	ग्रीनलैंडिक
Gurr-goni	गुर्र-गोनी
Greek	ग्रीक
Gurma	गुरमा
Gurenne	गुरें
Guro	गुरो
German	जर्मन
Garrwa	गरवा
Garus	गरस
Gorontalo	गोरोन्तालो
Greenlandic	ग्रीनलैंडिक
Greek Sign Language	ग्रीक सांकेतिक भाषा
Greenlandic	ग्रीनलैंडिक
German	जर्मन
German	जर्मन
German	जर्मन
Gude	यार
Guere	गेरे थे
Gupapuyngu	गोप्पुयनगु
Gugada	गुगाड़ा
Guhu-Samane	गुहू-समाने
Gujarati	गुजराती
Gula	गुला
Gumbaynggir	गुंबजयंगिर
Gunu	गोनू
Guaque	गुटका
Gurung	गुरुंग
Gusii	गुसाईं
Guugu Yimidhirr	गुगु यिमिधिर
Gungbe	गूंजा
German	जर्मन
Gwari	गिरि
German	जर्मन
Gworok	गोरवोक
Guayabero	ग्वायबेरो
Gyarong	ग्यारॉन्ग
German	जर्मन
Hadza	हदज़ा
Haida	हैदा
Hakka	हक्का
Halia	हलिया
Hamtai	हमताई
Hani	हानी
Haruai	हरुइ
Hatam	हाटम
Hausa	होसा
Havasupai	हवासुपाई
Hawaiian	हवाईयन
Hayu	हायू
Hebrew	हिब्रू
Haitian Creole	हाईटियन क्रियोल
Hdi	हदि
Hebrew	हिब्रू
Hehe	हेहे
Heiltsuk	Heiltsuk
Hemba	हेम्बा
Herero	बगुला
Hanga Hundi	हँगा हुंडी
Hianacoto	हियानकोतो
Hidatsa	हिदत्सा
Hiligaynon	हिलिगायोन
Hindi	हिन्दी
Hixkaryana	हिक्सकार्यण
Hong Kong Sign Language	हांगकांग सांकेतिक भाषा
Halbi	हल्बी
Halkomelem	Halkomelem
Halang	हलांग
Hualapai	Hualapai
Halkomelem	Halkomelem
Hmar	हमार
Huambisa	हंबिसा
Hmong Daw	हमोंग दाव
Huitoto	हुइतोटो
Hmong Njua	हमोंग नजुआ
Hamer	हामर
Huitoto	Huitoto
Mina	मीना
Hunde	हंडे
Hinuq	हिनुक
Haida	हैदा
Ho	हो
Hoava	होवा
Min	मिन
Holoholo	होलोहोलो
Hopi	होपी
Hup	हप
Hre	हरे
Harari	हरारी
Harsusi	हरसुसी
Haisla	हिसला
Huastec	Huastec
Hua	हुआ
=|Hoan	= | होन
Huichol	Huichol
Huitoto	Huitoto
Hungarian	हंगेरियन
Hupa	हुपा
Huave	हुवे
Hawaiian Creole	हवाईयन क्रियोल
Hawrami	हरामि
Haya	हया
Hyow	हाय
Hunzib	हुन्जीब
Iaai	इया ai
Iatmul	इत्तमुल
Iau	Iau
Iban	इबान
Ibibio	इबियो
Ibanag	इबानबाग
Icelandic	आइसलैंडिक
Icelandic Sign Language	आइसलैंडिक सांकेतिक भाषा
Iduna	इडुना
Idoma	इदोमा
Idu	इडु
Italian	इतालवी
Ifumu	इफुमु
Ifugao	इफुगाओ
Inga	इनगा
Igbo	इग्बो
Igede	Igede
Ignaciano	इग्नासीनो
Ingessana	इंगसाना
Iha	इहा
Indonesian	इंडोनेशियाई
Ijo	Ijo
Ik	इक
Ika	इका
Ila	इला
Illinois	इलिनोइस
Ilocano	Ilocano
Imonda	इमोंडा
Inanwatan	इनानवतन
Indonesian	इंडोनेशियाई
Ingush	इंगुश
Indonesian	इंडोनेशियाई
Innamincka	इन्नामिनेका
Inuktitut	इनूकीटूत्
Inuktitut	इनूकीटूत्
Indo-Pakistani Sign Language	भारत-पाकिस्तान सांकेतिक भाषा
Indo-Pakistani Sign Language	इंडो-पाकिस्तानी साइन लैंग्वेज
Inuktitut	इनक्यूटिलेट
Iquito	Iquito
Irish	आयरिश
Irish	आयरिश
Irish	आयरिश
Iraqw	इराक ने
Irarutu	इरारतु
Irish Sign Language	आयरिश सांकेतिक भाषा
Iranxe	ईरानी
I'saka	मैं आका
Isekiri	इसेकिरी
Ishkashmi	इश्क़मी
Isirawa	इशीरावा
International Sign	इंटरनेशनल साइन
Isnag	इसनाग
Isoko	इसोको
Israeli Sign Language	इजरायली सांकेतिक भाषा
Italian	इतालवी
Italian	इतालवी
Itelmen	Itelmen
Italian	इतालवी
Italian	इतालवी
Itonama	इटोनाम
Italian	इटालियन
Itawis	इटाविस
Itzaj	इत्जज
Ivatan	इवतन
Iwaidja	इवादिजा
Iwam	इवम
Ixcatec	Ixcatec
Ixil	Ixil
Izhor	Izhor
Izi	इजी
Jad	जद
Jahai	जही
Jakaltek	जकलटेक
Jaminjung	जामिनजंग
Jaqaru	जकरु
Jarawa	जारवा
Javanese	जवानी
Jamaican Creole	जमैका क्रियोल
Jebero	Jebero
Jeh	जेह
Jeli	जेली
Jemez	जेमेज़
Jiarong	जिरोंग
Jibbali	जिबली
Jino	जिनो
Jivaro	जिवारो
Luwo	लुवो
Jamamadi	जममाड़ी
Jamsay	जमशेद
Jingpho	जिंगफो
Johari	जोहरी
Jomang	जोमांग
Japanese	जापानी
Japreria	जाप्रिया
Juruna	जरुना
Jarawa	जारवा
Jugli	जुगली
Ju|'hoan	जू | ’होन
Jukun	जुकुन
Juang	जुआंग
Jurchen	जुरचें
Jarawara	जरवरा
Kabardian	काबर्डियन
Kachari	कचहरी
Kadugli	कडुगली
Kaki Ae	काकी ऐ
Komering	कोमर्सिंग
Kaian	कायन
Kaure	कायर
Kamano-Kafe	कमनो-केफे
Kalami	कलमी
Kambera	कांबेरा
Kana	काना
Karao	करौ
Kela	केला
Kaurna	कौरना
Kara	कारा
Kashmiri	कश्मीरी
Kaulong	कौलोंग
Kayardild	काइरिल्ड
Kazakh	कजाख
Kamba	कम्मो
Kabui	कबुई
Kabyle	कबाइल
Kambot	कंबोट
Kayan	कायन
Kabatei	कबेटी
Kanembu	कानम्बू
Karen	करेन
Koyra Chiini	कोयरा चिनि
Konda	कोंडा
Karipuna	करिपुना
Kadazan	कदजन
Kanjobal	कंजोबाल
Kedang	केदांग
Kefa	केफा
Kei	केई
Kele	केल
Kemant	केमंत
Kenga	केंगा
Keo	कीओ
Kera	केरा
Ket	केत
Kenyah	केन्याहा
Kewa	केवा
Kriol	क्रियोल
Koromfe	कोरोमेफ़
Kirghiz	किर्गिज़
Kinga	राजा
Konyagi	कोन्यागी
Umbu Ungu	अम्बु उनग
Kagoma	कागोमा
Kagulu	कागुलु
Kangiryuarmiut	कांगिरयुर्मिउत
Kalkatungu	कालकातुंगु
Kyirong	क्यारॉन्ग
Kirghiz	किरघिज़
Khalkha	खलख
Kham	खम
Khaling	खलिंग
Khinalug	खिनालुग
Khakas	खाकस
Khalaj	खलज
Khmer	खमेर
Nama	नामा
Kharia	खारिया
Khasi	खासी
Khumi	खुमी
 Khwarshi	 ख्वारशी
Khowar	खोवार
Kickapoo	किकापू
Kire	कीर
Kitja	किटजा
Kikuyu	किकुयू
Kiluba	किलुबा
Kimaghama	किमगामा
Kinyarwanda	किन्नरवांडा
Kiowa	कीवा
Kalmyk	कलमीक
Kirma	किरमा
Kisi	केसी
Kitsai	कित्सई
Kui	कुई
Kiwai	किवी
Koreguaje	कोरेगुजे
Kurmanji	कुरमानजी
Kunjen	कुंजें
Konjo	कोंजो
Koorete	कुरेते
Konkomba	कोंकम्बा
Kata Kolok	काटा कोलोक
Konkani	कोंकणी
Koranko	कोरानको
Karakalpak	करकलपाक
Kirikiri	किरकिरी
Kokota	कोकोटा
Korku	कोरकू
Lusi	लुसी
Karankawa	करनकवा
Kankanay	कंकणय
Kokni	कोकनी
Klao	कलो
Kilba	किलबा
Kulung	कुलंग
Kalasha	कलशा
Kaili	कैली
Koh	कोह
Kaluli	कलौली
Klamath	कालमठ
Kolana	कोलाना
Kalapuya	कलापुया
Kalam	कलाम
Koluri	कोलुरी
Kalispel	कालिस्पेल
Kelabit	केलाबिट
Kilivila	किलिविला
Kiliwa	किलिवा
Kala Lagaw Ya	काल लगाव या
Kalanga	कलंगा
Kombai	कोम्बाई
Kham	खाम
Kami	कामी
Karimojong	करिमोंगोंग
Kalmyk	कलमीक
Kuman	कुमां
Koiali	कोयाली
Kunimaipa	कुणिमापा
Kamoro	कामोरो
Kamass	कामस
Kemtuik	केमटिक
Khmu'	खमु '
Kamu	कामू
Kamasau	कमसाऊ
Kanum	कानुम
Kugu Nganhcara	कुग नग्नेकारा
Kannada	कन्नड़
Kaingang	कायांग
Konni	कोनी
Kanakuru	कनकुरु
Kunama	कुनामा
Kinnauri	किन्नौरी
Kanum	कानुम
Kriol	क्रियोल
Kanuri	कनुरी
Konua	कोनुआ
Konkow	कोनको
Kham	खाम
Koasati	कोसती
Kobon	कोबोन
Kodava	कोदवा
Kohumono	कोहमोनो
Koiari	कोयरी
Kokborok	कोकबोरोक
Kolami	कोलमी
Komo	कोमो
Kongo	कोंगो
Kola	कोला
Komi-Permyak	कोमी-पर्म्याक
Korean	कोरियन
Kosraean	कोसराइन
Kota	कोटा
Kom	कोम
Ko	को
Koya	कोय
Kpan	कोपन
Kpelle	केपीएल
Kapampangan	कपमंगन
Kapingamarangi	कपिंगमारंगी
Kposo	कोप्सो
Karen	करेन
Krenak	Krenak
Kara	कारा
Kiribati	किरीबाती
Karachay-Balkar	करचाय-बलकार
Kurdish	कुर्द
Kresh	क्रेश
Korafe	कोराफे
Karanga	करंगा
Kipea	किपिया
Karadjeri	कराडजेरी
Karok	करोक
Karelian	करेलियन
Karaim	करीम
Korana	कोराना
Krongo	क्रोंगो
Kerek	केरेक
Kairiru	कैरीरू
Karata	कर्ता
Korowai	कोरोवाई
Koryak	Koryak
Kryz	क्रिज
Keresan	केरेसन
Koyraboro Senni	प्रमुख शीर्षक
Karen	करेन
Kashaya	कषाय
Ksingmul	किसिंगमुल
Kenyan Sign Language	केन्याई सांकेतिक भाषा
Kasem	कसम से
Kasong	कसौंग
Kosop	कोसोप
Kisar	किसार
Kisi	केसी
Kashubian	काशुबियन
Koita	कोइता
Kituba	किटुबा
Katcha	कत्था
Kete	केट
Kutchin	कच्छिन
Kati	कटि
Kotoko	कोटको
Katla	कतला
Kathlamet	कथालमेट
Ketengban	केटेंगबन
Kato	काटो
Ketapang	केतापंग
Kott	कोट्ट
Katu	कटु
Khanty	खांटी
Kati	कटि
Kualan	कुआलन
Kunming	कुनमिंग
Kui	कुई
Kullo	कुलो
Kumauni	कुमाउनी
Kuna	कुना
Kuot	कुओट
Kumyk	कुमीक
Kurukh	कुरुख
Kusunda	कुसुंडा
Kutenai	कुटेनाई
Kuuku Ya'u	कुकु य'ु
Kuvi	कुवी
Kutai	कुताई
Kulamanen	कुलमनेन
Kwaio	क्वायो
Kwerba	कीर्बा
Kanjobal	कंजोबाल
Kwakw'ala	Kwakw'ala
Kwami	क्वामी
Kwangali	क्वांगाली
Kwoma	क्वामा
Kwamera	क्वामेरा
Kawaiisu	कवाइसु
Kwomtari	क्वोमटारी
Iwoyo	Iwoyo
Kwaza	क्वाजा
Kxoe	Kxoe
Kuku-Yalanji	कुकु-यालनजी
Kenyang	केनांग
Kyaka	काका
Kayah Li	काया ली
Krymchak	क्रिम्मक
Koyukon	कोयुकन
Kanyok	कान्योक
Kyuquot	Kyuquot
Karkar-Yuri	कर्कर-यूरी
Kaytej	कयतेज
Komi-Zyrian	कोमी-ज़िरियन
Laal	लल
Labu	लाबू
Ladakhi	लद्दाखी
Lafofa	लाफोफा
Lagwan	लगवान
Lahu	लहू
Lai	लाई
Lak	लक
Lalo	लालो
Lango	लैंगो
Lao	लाओ
Laragia	लरागिया
Latvian	लातवियाई
Lau	लाउ
Lavukaleve	लवकुलेव
Laz	लज
Lunda	लुंडा
Lachi	लाछी
Lesser Antillean French Creole	लेसर एंटिलियन फ्रेंच क्रियोल
Luganda	लुगंडा
Ladin	लादिन
Londo	लोंडो
Lendu	लेंडु
Lebeo	लेबेओ
Leko	लेको
Lega	लेगा
Lele	लेले
Lenakel	लेनकेल
Lepcha	लेपचा
Lese	झूठ बोलना
Leti	लेटि
Lewo	लेवो
Lezgian	Lezgian
Luangiua	लुआंगिया
Low German	कम जर्मन
Lughat al-Isharat al-Lubnaniya	लुघाट अल-इशरत अल-लुबनिया
Langi	लंगी
Logoti	लोगोती
Longgu	लोंगगु
Laha	लाहा
Lhomi	लोहमी
Hlai	Hlai
Lingua Italiana dei Segni	लिंगुआ इटालियन देई सेग्नि
Lillooet	Lillooet
Limbu	लिंबू
Lingala	लिंगाला
Lisu	लिसु
Lithuanian	लिथुआनियाई
Liv	लिव
Lauje	लाउजे
Lakkia	लक्किया
Lakhota	लखोटा
Lamu-Lamu	लमू-लमू
Lelemi	लेलेमी
Loma	लोमा
Lamba	लांबा
Lamang	लमंग
Lamaholot	लमाहोलोट
Limilngan	लिमिलगन
Lamani	लमानी
Lampung	लैम्पुंग
Lamen	लामेन
Linda	लिंडा
Lengua	लेंगुआ
Linngithig	लिनिंगिथिग
Ladino	लाडीनो
Lamnso'	लैम्नो
Lonwolwol	लोनावोलोल
Lobi	लोबी
Loko	लोको
Loniu	लोनिउ
Lotha	लोथा
Lou	लू
Loven	प्यार किया
Lozi	लोजी
Lardil	लार्डिल
Larike	लारिक
Lua	लुआ
Lucazi	लुकाज़ी
Lun Dayeh	लुन दयाह
Lugbara	लुगबारा
Lule	नियम
Lummi	लुम्मी
Lungchang	लुंगचांग
Luo	लुओ
Luri	लुरी
Lushootseed	रसीला लूट लिया
Luvale	लुवले
Luxemburgeois	लक्समबर्ग
Luyia	लुइया
Lyele	लाइले
Ma	मा
Maasai	मासाई
Maba	माबा
Macushi	मैकूशी
Ma'di	मैडी
Mae	माए
Magar	मगर
Mari	मारी
Maithili	मैथिली
Majang	मझंग
Makah	मका
Malagasy	मालागासी
Mam	मैम
Mano	मनो
Maori	माओरी
Mapudungun	मापुदुंगुन
Maricopa	मारीकोपा
Masa	मासा
Maung	मूँग
Maring	मार करना
Maninka	मणिन्का
Maybrat	मायब्रत
Mazahua	मझुआ
Mba	Mba
Mbabaram	मब्बाराम
Mbere	Mbere हैं
Mbugu	म्बुगु
Mbili	मैबिली
Mbole	म्बोल
Mbum	एमबीएम
Monumbo	मोनुम्बो
Mbara	एमबीरा
Mangbetu	मंगबेटु
Manambu	मानम्बु
Mbay	Mbay
Mbe'	Mbe '
Maca	मैका
Mochica	मोचिका
Macedonian	मैसेडोनियन
Michif	मिचिफ
Machiguenga	माचिगुआंगा
Macuna	मैकूना
Mixe	मिसे
Mauritian Creole	मॉरीशस क्रियोल
Miwok	मिवोक
Mada	माडा
Mudburra	मुदबरा
Mende	मेंड
Mundang	मुंडंग
Mandinka	मंदिंका
Matngele	Matngele
Madimadi	मदिमदी
Mandan	मंडन
Mbodomo	मबोडोमो
Madurese	मदुरासी
Manadonese	मैनाडोनीस
Mbosi	मबोसि
Mada	माडा
Meyah	मैया
Melayu Betawi	मेलयौ बेटावी
Me'en	मैं
Mehri	मेहरी
Meithei	मीठी
Mekens	मीकेन
Melanau	मेलानू
Manem	मनम
Menomini	मेनोमिनी
Meryam Mir	मेरियम मीर
Menya	मेन्या
Mondunga	मोंडुंगा
Mongondow	Mongondow
Mangghuer	मँगरू
Magahi	मगही
Magi	मैगी
Mungaka	मुनगाका
Mingrelian	मिंग्रेलियन
Magindanao	मगिंदानाओ
Mongo	मानगो
Mango	आम
Musgu	मुसगु
Mahican	महकान
Marathi	मराठी
Mehek	महक
Miri	मिरी
Mah Meri	मह मेरी
Mbalanhu	मलबनहु
Micmac	माइमैक
Midob	Midob
Mien	मियां
Migama	मिगामा
Miisiirii	मिसीसिर
Miju	मिजू
Mikir	मिकिर
Milang	मिलांग
Minangkabau	मिनंगकबाउ
Miriwung	मिरिवंग
Miskito	मिस्किटो
Mituku	मितुकु
Miya	मिया
Mizo	मिजो
Mixtec	मिक्सटेक
Mixtec	मिक्सटेक
Manjaku	मंजाकु
Mauka	मौका
Miwok	मिवोक
Makonde	माकंडे
Mekeo	मेकेओ
Mandinka	मैंडिन्का
Mongol	मंगोल
Mikasuki	मिकासुकी
Makasae	मकासे
Maklew	मकलेव
Mankanya	मनकन्या
Mokilko	मोकिलको
Mankon	मैनकॉन
Mikarew	मकारेव
Makassar	मकसर
Maranungku	मारनंगकु
Makaa	मका
Mambila	मांबिला
Malacca Creole	मलक्का क्रियोल
Maale	माले
Malgwa	मालगावा
Mali	माली
Malakmalak	मालामालक
Molala	मोलाला
Mlabri	मलबरी
Maltese	माल्टीज़
Maleu	मािलु
Malay	मलय
Mandaic	मंदिक
Mangap-Mbula	मंगप-एमबीूला
Mari	मारी
Mambai	माँबाई
Mamanwa	मामनवा
Mordvin	मोर्डविन
Mampruli	ममप्रुली
Mamasa	ममसा
Malay	मलय
Mamvu	मामवु
Mambwe	मेम्बवे
Muna	मुन्ना
Manchu	मांचू
Mandarin	मंदारिन
Maidu	मैदान
Manggarai	मंगरगाई
Moni	मोनी
Mantjiltjara	मंतजिल्टजारा
Maninka	मणिन्का
Manam	मनम
Mono	मोनो
Mandar	मंदार
Mansi	मानसी
Mentawai	मेंतवई
Mun	मुन
Minaveha	मिनावेहा
Manx	मैनक्स
Margany	मार्गणी
Munzombo	मुंजोमबो
Mono-Alu	मोनो- अलु
Moca	मोका
Mordvin	मोर्डविन
Mofu-Gudur	मोफू-गुदुर
Moghol	मोगल
Mohawk	मोहॉक
Mojave	मोजावे
Mokilese	Mokilese
Moldavian	मोलदावियन
Mombum	मोम्बम
Mon	सोमवार
Mopan	मोपान
Mor	मोर
Motuna	मोटूणा
Moru	मोरु
Movima	मूवमा
Murrinh-Patha	मुरिन्ह-पाठ
Mpongwe	Mpongwe
Maipure	महीप
Mian	मियां
Mpur	एमपुर
Mapoyo	माप्यो
Martinique Creole	मार्टिनिक क्रियोल
Momuna	मोमुना
Mara	मारा
Marchha	मरघट
Marind	मारिंड
Margi	मार्गी
Marrithiyel	Marrithiyel
Moraori	मोरौरी
Mirniny	चमत्कारी
Murik	मुरिक
Murle	मुरले
Maranao	मारनाओ
Moro	मोरो
Marquesan	मैरिकसन
Maringarr	मैरिंग
Mairasi	मायरासी
Martuthunira	मारुथुनीरा
Maru	मारू
Muruwari	मुरुवारी
Muisca	मुइस्का
Munsee	मुन्से
Mising	Mising
Marshallese	मार्शल
Masakin	मसकिन
Masalit	मसलित
Musom	मुसोम
Maisin	मैिसन
Musqueam	कस्तूरी
Miwok	मिवोक
Magar	मगर
Mentuh Tapuh	मेंतुह तपु
Matuumbi	मटुंबी
Montagnais	मोंटगैनिस
Mixe	मिसे
Matukar	मटुकर
Mattole	मटोल
Malto	माल्टो
Mixe	मिक्स
Matis	मैटिस
Massachusett	नरसंहार
Motu	मोटू
Makua	मकुआ
Mundani	मुंडनी
Bargam	बड़गाम
Muher	मुहेर
Muinane	मुिनने
Mulao	मुलओ
Mumuye	मुमुई
Mundari	मुंडारी
Muong	मूंग
Mupun	मुपुन
Mursi	मुर्सी
Mussau	मुसौ
Mutsun	मुत्सुन
Muyuw	Muyuw
Martu Wangka	मार्टू वांगका
Manobo	मानोबो
Mawchi	मवची
Mwera	मेवेरा
Miwok	मिवोक
Miwok	मिवोक
Mwotlap	Mwotlap
Miwok	मिवोक
Mixtec	मिक्सटेक
Mixtec	मिक्सटेक
Ifira-Mele	इफिरा-मेले
Mixtec	मिक्सटेक
Mixtec	मिक्सटेक
Mixtec	मिक्सटेक
Mixtec	मिक्सटेक
Mixtec	मिक्सटेक
Mixtec	मिक्सटेक
Mixtec	मिक्सटेक
Mixtec	मिक्सटेक
Mixtec	मिक्सटेक
Mixe	मिसे
Mixtec	मिक्सटेक
Mixtec	मिक्सटेक
Ma'ya	माया
Mayogo	मयोगो
Mangarrayi	मंगरेरी
Malay	मलय
Malayalam	मलयालम
Ma'anyan	मै’यान
Mayo	मेयो
Mayi-Yapi	माया-यपी
Mazatec	माज़ेटेक
Mazatec	मजतेक
Mazanderani	माज़ंदरानी
Neo-Aramaic	नव-अरामिक
Nabak	नबक
Nafaanra	नफनरा
Nagatman	नागतमान
Nahali	नाहली
Nanai	नानाइ
Neo-Aramaic	नव-अरामिक
Nakanai	नकनई
Nalik	नलिक
Namia	नामिया
Nandi	नंदी
Neo-Aramaic	नव-अरामिक
Nara	नारा
Nasioi	नासियोइ
Natchez	नाचेज़
Nauruan	नौरुण
Navajo	नवाजो
Naxi	नक्सी
Nambas	नंबास
Nubian	न्युबियन
Ngombe	Ngombe
Ghulfan	घुलना
Ngbaka	Ngbaka
Nyambo	Nyambo
Nicobarese	निकोबारिस
Ndebele	Ndebele
Nande	ननदे
Ndogo	एनडोगो
Ngbandi	नगबंधी
Ndonga	नडोंगा
Nadroga	नाद्रोगा
Ndut	नाडू
Ndumu	नडुमु
Ndyuka	निदुका
Nederlandse Gebarentaal	नेदरलैंड्स गेबरेंटल
Negidal	नकारात्मक
Nehan	नेह
Nelemwa	नेलेमवा
Nenets	नेनेट्स
Nepali	नेपाली
Nevome	नेवोम
Newari	नेवारी
Neyo	पूर्वोत्तर यो
Nez Perce	नेज परसे
Nganasan	नगनसन
Ngbaka	Ngbaka
Ngad'a	नगाड़ा
Ngemba	Ngemba
Ngan'gityemerri	नगन'गीतमेरी
Ngiyambaa	Ngiyambaa
Ngadjumaja	नगदजुमाजा
Ngankikurungkurr	नगानिकिकुरंगकर्क
Ngalakan	नगालकन
Ngambay	Ngambay
Ngandi	नगंडी
Ngoni	Ngoni
Ngarinyeri	नार्जीनेरी
Naga	नागा
Nguna	नगुना
Ngawun	Ngawun
Ngarinyman	नर्गिनिमन
Ngizim	Ngizim
Nhanda	नन्दा
Nahuatl	नाहुताल
Nahuatl	नाहुताल
Nahuatl	नहाहालत
Nahuatl	नाहुताल
Nahuatl	नाहुताल
Nahuatl	नहलत्ल
Nahuatl	नहाहालत
Nahuatl	नाहुताल
Nias	नियास
Nicobarese	निकोबारी
Niuafo'ou	नुआफो
Nihon Shuwa	निहोन शुवा
Nimboran	निंबोरन
Ningil	निंगिल
Nyishi	निशि
Nitinaht	नितिनहाट
Niuean	नीयन
Nivkh	निवाख
Nyungar	न्यांगर
Ngalkbun	मंगलकबुन
Nkem	Nkem
Nakkara	नक्कारा
Nkonya	नकोनिआ
Nkore-Kiga	नकोर-किगा
Nukuoro	नुकोरो
Nyah Kur	न्यह कुर
Nubian	न्युबियन
Ngarla	नगला
Ngarluma	नंगलुमा
Nyamal	न्यामल
Naga	नागा
Samo	समो
Nahuatl	नाहुतल
Manange	मानंगे
Nahuatl	नाहुलात
Nancowry	नानकौरी
Nend	निंद
Nengone	नेंगोन
Nyanga	न्यांगा
Nankina	नानकिना
Nanumea	नानूमीया
Nuni	नूनी
Nanticoke	Nanticoke
Nobiin	नौबिन
Nocte	निशाचर
Noghay	नघाय
Noghay	नोगेय
Nomatsiguenga	नोमत्सिगुन्गा
Noni	नोनी
Noon	दोपहर
Norwegian	नॉर्वेजियन
Nahuatl	नाहुताल
Nar-Phu	नर-फु
Nigerian Pidgin	नाइजीरियाई पिजिन
Naga Pidgin	नागा पिदगिन
Napu	नपु
Nanerge	नानगर
Narom	Narom
Nharo	नहरो
Nsenga	सत्संग
Nisgha	निसघा
Naskapi	नस्कापी
Nisenan	निसेन
Neo-Aramaic	नव-अरामिक
Nahuatl	नाहुतल
Ngiti	Ngiti
Ngaanyatjarra	नागान्यतजार
Nateni	नटनी
Ntomba	Ntomba
Nenets	नेनेट
Nuaulu	नुआलु
Nubi	नुबी
Nuer	नुअर
Nunggubuyu	नुंगगुब्यु
Nukak	नुक्कड़
Nung	नंग
Nupe	नुपे
Nusu	Nusu
Nuuchahnulth	नूचाहनुलथ
Nivkh	निवख
Newar	नेवार
Nyawaygi	नयवेगी
Nyangi	न्यांगी
Nyiha	नइहा
Nyimang	न्यामंग
Nyamkad	न्यामकद
Nyamwezi	Nyamwezi
Nyigina	Nyigina
Nyangumarda	न्यांगुमर्दा
Nyulnyul	Nyulnyul
Nzakara	नजकारा
Naga	नागा
New Zealand Sign Language	न्यूजीलैंड सांकेतिक भाषा
Ogbronuagum	ओबरगोनुगम
Obokuitai	ओबोकिटाई
Obolo	ओबोलो
Ocaina	Ocaina
Occitan	फूल
Ocuilteco	Ocuilteco
Ogbia	Ogbia
Oi	ओय
Oirat	ओिरत
Ojibwa	ओजीबावा
Ojibwe	ओजीब्वे
Ojibwa	ओजीबवा
Okanagan	ओकानगन
Oriya	उड़िया
Oksapmin	ओक्सापिन
Oku	ठीक है
Oloh Mangtangai	ओलोह मंगतंगई
Olo	ओलो
Olutec	ओलुटेक
Omagua	ओमगुआ
Omaha	ओमाहा
Oneida	वनइडा
One	एक
Onge	ओनगे
Onondaga	ओंडोंगा
Ono	ओनो
O'odham	ओयोदम
Emai	Emai
Oromo	ओरोमो
Oroch	ओरच
Ordos	आयुध
Oromo	ओरोमो
Orig	मूल
Orok	ओरोक
Orokolo	ओरोकलो
Ormuri	ओरमुरी
Orokaiva	ओरोकाइवा
Oromo	ओरोमो
Orya	ओरी
Osage	ओसेज
Ossetic	ओस्सेटिक
Oto	ओटो
Otoro	ओटोरो
Oromo	ओरोमो
Owininga	मालिकाना
Oriya	ओरिया
Pa'a	पा ’
Pacoh	पचोह
Padoe	पादो
Pagu	पगु
Paiwan	पावन
Pakanha	पखाना
Palauan	पलौआँ
Pame	पमे
Panjabi	पंजाबी
Papiamentu	पापमुन्टु
Patep	Patep
Pawaian	पावियन
Pima Bajo	पीमा बाजो
Poqomam	पूकोम
Folopa	फूलोपा
Pech	जोंक
Pemon	उपमा
Pengo	पेंगो
Pero	पेरो
Pingilapese	पिंगिलपेस
Phlong	लम्बा
Piaroa	पियरौआ
Pileni	पिलानी
Pintupi	पिंटुपी
Pipil	पिपील
Piro	पीरो
Pisa	पीसा
Pitjantjatjara	पीतजंतजतारा
Paakantyi	पाकांति
Pokot	पोकोट
Playero	Playero
Polabian	Polabian
Palaung	पलांग
Paulohi	पौलोही
Palikur	पालिकुर
Pulopetak	पुलोपेटक
Palor	पालोर
Pomo	पोमो
Pomo	पोमो
Pomo	पोमो
Paamese	पैमसे
Pamona	पामोना
Pangwa	पंगवा
Pangasinan	पंगासिनन
Paiute	पाय्यूट
Panare	पनारे
Bunu	बून
Panyjima	पञ्जीमा
Po-Ai	पो- ऐ
Podoko	पोडोको
Pogoro	पोगोरो
Pohnpeian	पोनपियान
Poko-Rawo	पोको-रावो
Polish	पोलिश करना
Popoloca	पॉपोलोका
Portuguese	पुर्तगाली
Potawatomi	पोटावाटोमी
Powhatan	पावतान
Piapoco	पियापोको
Pitta Pitta	पित्त पित्त
Prasuni	प्रसूनि
Paresi	पारसी
Parji	पारजी
Pare	पारे
Purki	पुरकी
Persian	फारसी
Piratapuyo	पिरतापुयो
Pashto	पश्तो
Popoloca	पॉपोलोका
Plains-Indians Sign Language	मैदान-भारतीय सांकेतिक भाषा
Passamaquoddy-Maliseet	पासमाक्कोड्डी-मालिसेट
Pomo	पोमो
Popoloca	पॉपोलोका
Port Sandwich	पोर्ट सैंडविच
Paita	पैता
Paite	पाइते
Patpatar	पटपतर
Pattani	पटरानी
Patwin	पटविन
Puinave	पुनाइवे
Parauk	पारुक
Puluwat	पुलुवत
Pumi	पुमी
Pungupungu	पुंगुपुंगु
Puquina	पुक्विना
Paiute	पाय्यूट
Pawnee	पावनी
Qafar	कफर
Quechua	क्वेशुआ
Qawasqar	कवसकर
Quechua	क्वेशुआ
Quechua	क्वेशुआ
Quechua	क्वेशुआ
Quechua	क्वेशुआ
Quechua	क्वेशुआ
Quechua	क्वेशुआ
Quechua	क्वेशुआ
Qiang	किआंग
Quechua	क्वेशुआ
Quechua	क्वेशुआ
Quechan	क्वैश्चन
Quileute	वशीकरण
Sipakapense	सिपाकैपेंस
Rade	राड
Raga	राग
Ralte	राल्ते
Rama	राम अ
Rao	राव
Rapanui	रापानुई
Rashad	राशद
Romani	रोमानी
Rawang	रावंग
Romani	रोमानी
Romani	रोमानी
Russian-Chinese Pidgin	रूसी-चीनी पिजिन
Rejang	रेजांग
Remo	रेमो
Rendille	रेंडिल
Ronga	रोंगा
rGyalrong	rGyalrong
Roglai	रोजलाई
Riantana	रियानाटाना
Rikbaktsa	रिकाबकट्स
Rimi	रिमी
Ritharngu	रिठारंगु
Raji	राजी
Romani	रोमानी
Romani	रोमानी
Rembarnga	रेम्बर्गा
Romansch	रोमन
Rundi	रंडी
Rengao	रेंगाओ
Rennellese	Rennellese
Romani	रोमानी
Runyankore	धावनकोर
Romanian	रोमानियाई
Ron	रॉन
Roro	रोरो
Rotuman	रोटमन
Roviana	रोवियाना
Rang Pas	रंग पस
Runyoro-Rutooro	रनयोरो-रूतूरो
Romansch	रोमान्श
Romani	रोमानी
Shughni	शुगनी
Russian Sign Language	रूसी सांकेतिक भाषा
Romansch	रोमन्सच
Romansch	रोमन्सच
Roti	रोटी
Rotokas	रोटोकस
Rukai	रुकाई
Rumu	रमू
Runga	रूंगा
Russian	रूसी
Rutul	रुतुल
Rawa	रवा
Romani	रोमानी
Shuri	शुरी
Sa'a	सा’आ
Sa'ban	सा'बन
Saek	सैक
Sahu	साहू
Sakao	सको
Salinan	सालिनन
Samoan	समोआ
Sango	सांगो
Saho	साहो
Sapuan	सपुआन
Sare	सरे
Savi	सवि
Sawu	सवु
Sayula Popoluca	सयुला पोपुलुका
Sama	साम
Saanich	सानीच
Serbian-Croatian	सर्बियाई-क्रोएशियाई
Saami	सामी
Sindhi	सिंधी
Sandawe	संडावे
Southeast Ambrym	दक्षिणपूर्वी राजवंश
Sebei	सेबी
Secoya	सिकोया
Sedang	सेडंग
Seediq	सीडीक
Selknam	सेल्कनाम
Sema	सेमा
Sena	सेना
Seri	सीरी
Sesotho	सेसोथो
Seychelles Creole	सेशेल्स क्रियोल
Sougb	सौबग
Songe	संगा
Sengele	सेनेगल
Sangir	संगीर
Songish	गीत
Sangu	संगु
Shan	शां
Shabo	शब्बो
Sherdukpen	शेरडुकपेन
Sherpa	शेरपा
Sharanahua	शरणाहुआ
Shiriana	शिरियाना
Shipibo-Konibo	शिपिबो-कोनिबो
Shilluk	शिलुक
Shambala	शम्बाला
Shona	शोना
Shoshone	Shoshone
Sahaptin	सहपटन
Shor	शोर
Shasta	शास्ता
Shatt	शट्ट
Shuswap	Shuswap
Shawnee	शावनी
Shira Yughur	शीरा युघुर
Siane	सियान
Sidaama	सिदामा
Sika	सिका
Sila	सिला
Simeulue	Simeulue
Siona	सिओना
Sio	सियो
Siar	सियार
Sisiqa	सिसिक्का
Siuslaw	स्यूस्लाव
Saami	सामी
Sikkimese	सिक्किमीज
Sikule	सिकुले
Sukuma	सुकुमा
Skou	स्कौ
Selkup	सेलकूप
Sikaritai	सिकरायताई
Suku	सुकु
Shekhawati	शेखावाटी
Slave	दास
Saliba	सलिबा
Samba Leko	सांभा लेको
Sulung	सुलुंग
Slovene	स्लोवेनिया
Selepet	सेलेपेट
Salar	सालार
Slavey	गुलाम
Selayar	सेलयार
Semandang	सेमलंग
Seme	वीर्य
Semai	सेमाई
Semelai	सेमलई
Seminole	सेमिनोल
Shompen	धूमिल करना
Sahaptin	सहपटन
Shina	शिन
Seneca	सेनेका
Senadi	सेनाडी
Sinaugoro	सिनागोरो
Sinhala	सिंहल
Sanuma	सानुमा
Soninke	सोनिन्के
Saami	सामी
Sentani	संतानी
So	इसलिए
Sobei	सोबी
Soddo	सोडो
Solon	सोलन
Somali	सोमाली
Sonsorol-Tobi	सोंसरोल-तोबी
Sooke	सूके
Soqotri	सोकोत्री
Sora	सोरा
Sorbian	सॉर्बियन
Spanish	स्पैनिश
Spanish	स्पेनिश
Spitian	स्पिटियन
Spokane	बोला हुआ
Salish	सलिश
Squamish	स्क्वामिश
Sranan	सरनान
Sorbian	सोरबियन
Sarcee	सरसे
Sardinian	सरदीन
Sre	श्री
Siriano	सिरियानो
Sorbian	सॉर्बियन
Saramaccan	Saramaccan
Siroi	सिरोई
Serrano	सेरानो
Selaru	सेलारु
Siraya	सिरया
Sisaala	सिसाला
Shinassha	शिनशाह
South Korean Sign Language	दक्षिण कोरियाई सांकेतिक भाषा
Salish	सलीश
Salish	सलीश
Santa	संता
Stieng	स्टेंग
Santali	संताली
Sotho	सोथो
Stoney	पथरीली
Subiya	सुबिया
Sudest	अचानक
Suena	सुएना
Sungor	सुंगोर
Sui	सुई
Suki	सूकी
Sulka	सुलका
Mayangna	मयंगना
Sundanese	सुंदनी
Supyire	सुपरिअर
Sursurunga	सुरसुरंगा
Susu	सुसु
Svan	सवन
Slovincian	नारा लगाने वाला
Slovak	स्लोवाक
Savosavo	सावोसावो
Swahili	स्वाहिली
Swedish	स्वीडिश
Sawai	सवाई
Shoshone	Shoshone
Swati	स्वाति
Swedish	स्वीडिश
Saryg Yughur	सरग युघुर
Salt-Yui	नमक-युई
Taba	तबा
Tacana	तचना
Taiof	तैफ
Tagalog	जुगनुओं का
Tahitian	ताहिती
Tuareg	तुआरेग
Tajik	ताजिक
Takia	तकिया
Talinga	बात करना
Tamang	तमांग
Tangale	तांगेले
Tarao	तारो
Taiap	तायाप
Tariana	तरियाना
Tashlhiyt	तशलीह
Tatana'	ताताना '
Tauya	तौया
Tawala	तावला
Tayo	तयो
Talysh	तलायश
Tabare	तबरेज
Tabla	तबला
Tboli	तबोली
Tabaru	तबरू
Tabassaran	तबरसन
Tobati	तोबाती
Tubu	टूबू
Tabwa	तबवा
Tangbe	टंगबे
Tarahumara	तराहुमारा
Toda	टोडा
Tibetan	तिब्बती
Tibetan	तिब्बती
Tectiteco	टेक्टिटको
Tepehua	तेपेहुआ
Tehuelche	तेहुलेच
Telugu	तेलुगु
Tem	अस्थायी
Tennet	टेनीट
Teop	बाघ
Tepehua	टेपेहुआ
Tera	तेरा
Teso	टेसू
Tetela	टेटेला
Tewa	टेवा
Turkic	तुर्किक
Tangga	तंगगा
Tagbanwa	तगबानवा
Tuareg	तुआरेग
Tigak	तिगाक
Tshangla	सहंगला
Tugun	तुगुन
Tsogo	त्सोगो
Tanglapui	तंगलापुई
Tarangan	तरंग
Thai	थाई
Thadou	ठाडौ
Thakali	ठकाली
Thangmi	थंगमी
Thompson	थॉम्पसन
Thaypan	थिपन
Thai Sign Language	थाई सांकेतिक भाषा
Tehit	तेहिट
Thulung	थुलुंग
Thao	थाओ
Kuuk Thaayorre	कुआक थायोर्रे
Tima	तिमा
Tibetan	तिब्बती
Ticuna	टिकुना
Tidore	टिडोर
Tifal	टिफ़ल
Tigrinya	बाघिन
Tikar	टिकर
Tillamook	तिलमुक
Timugon	टिमुगन
Tinrin	तिनिन
Tiriyo	तिरियो
Tibetan	तिब्बती
Tiv	तिव
Tiwi	तिवारी
Tiipay	तिपाई
Tokelauan	टोकेलुआन
Tuki	तुकी
Takelma	तकलमा
Turkmen	तुर्कमान
Teke	टेक
Tolai	तोलाई
Tatar-Noghay	तातार-नोगाय
Talaud	तालुद
Telefol	टेलीफ़ॉल
Tlingit	तलिंग
Taulil	तालिल
Tobelo	टोबेलो
Tlapanec	तल्पापेक
Talysh	तलिश्
Tama	तम ु
Timucua	टिमुकुआ
Tamagario	तमागारियो
Tatar	तातार
Tumak	तुमक
Tamil	तमिल
Tamabo	तमाबो
Temein	तेमीं in
Tibetan	तिब्बती
Tampulma	तम्पुलमा
Temiar	तेमियार
Tommo So	तोमो तो
Tat	टाट
Turkana	तुर्काना
Tunebo	टुनबो
Tanacross	तनाक्रॉस
Tindi	टिंडी
Temne	टेमने
Tongan	टोंगन
Tinani	तिनानी
Tanaina	तनैना
Tungak	तुंगक
Tanana	तन्ना
Tunen	ट्यून
Tondano	टोंडानो
Tanna	तन्ना
Tontemboan	टोंटेमोबन
Tenyer	किरायेदार
Toaripi	तोरईपी
Toba	टोबा
Tod	टॉड
Tofa	टोफा
Tojolabal	तजोलबल
Tarok	तारक
Tol	तोल
Tonkawa	टोंकवा
Toqabaqita	तोकबाकिता
Totonac	टोटोनैक
Totonac	टोटोनैक
Southern Toussian	सदर्न टूसियन
Tasmanian	तस्मानी
Tonga	टोंगा
Totonac	टोटोनैक
Tepecano	टेपकोनो
Tok Pisin	टोक पिसिन
Tepehuan	तेपहुआन
Tupuri	तुपुरी
Tepehuan	तेपहुआन
Teribe	टेरिबे
Trique	ट्राइक
Toraja	तोराजा
Tewa	तेवा
Trique	ट्राइक
Tirmaga	तिर्मगा
Tairora	तियोरा
Ternate	टर्ननेट
Trumai	ट्रुमाई
Torwali	तोरवाली
Tiruray	तिरुरे
Tsakhur	त्सखुर
Timorese	तिमोरिस
Tsafiki	त्सफिकी
Tausug	तासुग
Tsimshian	त्सिमिशियन
Tewa	तेवा
Tamashek	तमाशेख
Tanzania Sign Language	तंजानिया सांकेतिक भाषा
Tasmanian	तस्मानियन
Tsonga	सोंगा
Tsou	त्सौ
Tamil	तमिल
Taushiro	तौसीरो
Tsat	ज़ात
Tswana	त्सवना
Tsez	त्सेज़
Tatar	तातार
Tetun Dili	टेटुन डिलि
Tutelo	टूटेलो
Tetun	टेटुन
Tati	ताती
Tsova-Tush	त्सुवा-तुष
Tatuyo	तात्युओ
Tuamotuan	तुआमोटुआन
Tubar	कंद
Tucano	टूसनो
Tuareg	तुआरेग
Tukang Besi	तुकंग बेसी
Tulu	तुलु
Tumleo	टूमले
Tunica	टुनिका
Tupi	तुपी
Turkish	तुर्की
Tuscarora	टस्करोरा
Tutchone	Tutchone
Tuvan	तुवन
Tuyuca	तुयुका
Tuvaluan	तुवालुअन
Tatar	तातार
Tutsa	टुट्टा
Twana	ट्वाना
Tarahumara	तराहुमारा
Tiwa	तिवा
Tiwa	तिवा
Turkic	तुर्किक
Totonac	टोटोनैक
Tyeraity	क्षीणता
Tzeltal	त्ज़ेल्टल
Tzeltal	टज़्टटल
Taiwanese Sign Language	ताइवान की सांकेतिक भाषा
Tzotzil	तज़ोट्ज़िल
Tzeltal	त्ज़ेल्टल
Tzutujil	तजुत्जिल
Ubykh	उबख
Udihe	उडीहे
Udi	उदी
Udmurt	उम्मेद
Ugandan Sign Language	युगांडा साइन लैंग्वेज
Uradhi	उरदी
Ukrainian	यूक्रेनी
Upper Kuskokwim	अपर कुस्कोकविम
Ulcha	उल्चा
Uldeme	उल्डेमे
Ulithian	यूलिथियन
Uma	उमा
UMbundu	UMbundu
Umpila	उपमीला
Umaua	उमौआ
Una	ऊना
Ungarinjin	अनगरिनजाइन
Unami	उनामी
Ura	उरा
Urdu	उर्दू
Urhobo	उरहबो
Urim	उरीम
Urak Lawoi'	उराक लावोई '
Urum	उरुम
Urarina	उर्रीना
Urat	उरट
Uru	उरु
Usan	उसन
Usarufa	उसारूफा
Ute	उते
Uyghur	उइगर
Uzbek	उजबेक
Uzbek	उज़्बेक
Vafsi	वफसी
Vagla	वागला
Vai	वै
Vasavi	वासवी
Vata	वात
Vedda	वेद
Venda	वेन्दा
Veps	Veps
Vietnamese	वियतनामी
Vili	विली
Kariera	करियारा
Vlaamse Gebarentaal	वलामसे गेबरेंटल
Vinmavis	विन्माविस
Votic	वॉटिक
Wagiman	वागीमन
Wahgi	वाहगी
Wai Wai	वाई वाई
Wakhi	वाखी
Walman	वाल्मैन
Wambaya	वम्बया
Wangkumara	वंगकुमारा
Waorani	वोरानी
Wappo	वप्पो
Wari'	वारी ’
Washo	वाशो
Watjarri	वटजारी
Waunana	वुनना
Wayampi	वायम्पी
Wambon	वम्बन
Wanman	वानमान
Western Desert	वेस्टर्न डेजर्ट
Welsh	वेल्श
Wedau	वासौ
Welsh	वेल्श
Wembawemba	वेम्बवाम्
Weri	वारी
Wetan	वेटन
Wangkangurru	वांगकांगुरू
Waigali	वैगाली
Warrongo	वार्रंगो
Wichita	विचिता
Wikchamni	विकचमनी
Wintu	विंटू
Wirangu	विरंगु
Wiyot	Wiyot
Wagawaga	वागावागा
Wolof	वुल्फ
Wallisian	दीवार बनानेवाला
Walmatjari	वालमतारी
Wolio	वोलियो
Warluwara	वारलुवारा
Wolaytta	वोलयट्टा
West Makian	वेस्ट माकियन
Wambule	वम्बुले
Wik Munkan	विक मुनकन
Wik Ngathana	विक नगाथाना
Wan	वान
Winnebago	वाइनबागो
Wantoat	चाहत
Wobe	वाब
Wogamusin	वोगामुसिन
Woisika	वायसिका
Woleaian	वूलियन
Womo	वोमो
Worora	वरोरा
Wapishana	वैपिशना
Warao	वारो
Warrnambool	वारनंबूल
Wardaman	वार्डमैन
Warrgamay	वरमगमय
Warekena	वेयरनेका
Warlpiri	वरलपिरी
Warembori	गोदाम
Warndarang	वारंदरंग
Waropen	व्रोपेन
Waris	वारिस
Warumungu	वारुमुंगु
Warrwa	वार्रवा
Waray	वारय
Waskia	वास्किया
Wathawurrung	वाथवुरंग
Watam	वतम
Wu	वू
Waama	वामा
Woiwurrung	वाइवुरंग
Waray-Waray	वारय-वारय
Wyandot	व्यंदोत
Wayana	वायना
/Xam	/ ज़म
Xasonga	Xasonga
Kombio	कोम्बियो
Xhosa	Xhosa
Kanashi	कनाशी
Xokleng	Xokleng
!Xun	! ज़ून
Yagua	यागुआ
Yahgan	याहगान
Yaka	याका
Yale	येल
Yaminahua	यामिनाहुआ
Yana	याना
Yao	याओ
Yapese	यापीस
Yaqui	याकी
Yareba	यरेबा
Yavapai	यावपई
Yawa	यावा
Yay	वाह
Yazgulyam	यजगुलिम
Yamba	याम्बा
Yamphu	यम्फू
Yup'ik	युपिक
Yucuna	युकोना
Yucatec	युकातेक
Yiddish	येदिश
Yiddish	यिडिश
Yiddish	यिडिश
Yei	यय
Yemba	येम्बा
Yessan-Mayo	यासन-मेयो
Yeyi	येयी
Dii	दीि
Yaghnobi	यज्ञोनि
Yagaria	यगरिया
Nuosu	नुसू
Yidiny	यादि
Yil	यिल
Yimas	यामास
Yindjibarndi	यिंडजिबरेंडी
Yir Yoront	यार योरोंट
Yi	यी
Yuki	युकी
Yakoma	याकोमा
Yakan	यकान
Yukaghir	युकाघिर
Yukpa	युक्पा
Yakut	याकूत
Yulparija	यूलपरिजा
Yali	यली
Yelmek	येल्मेक
Yalarnnga	यलार्ंगना
Yiddish	यिडिश
Yamdena	यमदीना
Yami	यामी
Yemsa	यमेसा
Yupik	युपिक
Yingkarta	यिंगकर्त्ता
Yankuntjatjara	यानकुंजत्जरा
Yansi	यानसी
Yanyuwa	यानुवा
Yokuts	योकट्स
Yoruba	योरूबा
Yup'ik	युपिक
Yaqay	याके
Yuracare	यूराकेयर
Yaruro	यारो
Yuruti	युयुति
Yupik	युपिक
Yupik	युपिक
Yurt Tatar	यर्ट तातार
Yukaghir	युकाघिर
Yuchi	युची
Yugh	युघ
Yukulta	युकुलता
Yulu	युलु
Yup'ik	युपिक
Yurok	युरोक
Yupik	यूपिक
Yuwaalaraay	युवलाराय
Yawelmani	यवलमानी
Yawuru	यावरु
Yaygir	यायगीर
Yorta Yorta	योर्ता योर्टा
Yazva	यज़्वा
Beria	बेरिया
Zapotec	जैपोटेक
Zapotec	जैपोटेक
Zapotec	जैपोटेक
Zande	Zande
Zapotec	जैपोटेक
Zapotec	जैपोटेक
Zarma	ज़र्मा
Zayse	जायसी
Zazaki	ज़ज़की
Zoque	ज़ोक
Zenaga	झेनगा
Zoque	ज़ोक
Zhuang	ज़ुआंग
Zimakani	जिमाकनी
Zulu	ज़ुलु
Zapotec	जैपोटेक
Zaparo	जैपरो
Zoque	ज़ोक
Zoque	ज़ोक
Zoque	ज़ोक
Popoluca	पॉपोलुका
Zulu	ज़ुलु
Zapotec	जैपोटेक
Zapotec	जैपोटेक
Zulu	ज़ुलु
Zuni	ज़ूनी
Zapotec	ज़ापोटेक
Zapotec	ज़ापोटेक

